...###......#.#
..##.#.####.#.#
.##..###..#.#.#
##........#.#.#
#...@..#..#.#.#
###..###..#.#.#
..#..#....#.#.#
.##.##.#.##.#.#
.#......##..#.#
.#.....##...#.#
.#######....#.#